1111111111111
100P0000E0001
1000000000001
10000000E0001
1111111111111