1111111111111
100P0000E0001
1000001110001
1000001C10001
1111111111111