1111111111111
100P0001E1001
1000000010001
1000001C10001
1111111111111